_________ _______ _________ _______        ______
    |     |           |     |     |    |   |
    |     |           |     |     |    |   |
    |     |____       |     |_____|    |   |_____
    |     |           |     |  \       |        |
    |     |           |     |   \      |        |
    |     |______     |     |    \     |   _____|