/-------NEXT-------\
|                  |
|                  |
|                  |
|                  |
|                  |
|                  |
\------------------/